00 00 00 00 00 00 00 00 00 00 00 00 00 00 00 00 00 00 00 00 00 00 00 00 00 00 00 00 00 00 00 00 00 00 00 00 00 00 00 00 00 00 00 00 00 00
00 00 00 00 00 00 00 00 00 00 00 00 00 00 00 03 15 15 15 15 15 15 15 15 15 15 15 03 00 00 00 00 00 00 00 00 00 00 00 00 00 00 00 00 00 00
00 00 00 00 00 00 00 00 00 00 00 00 00 00 00 01 22 18 18 18 18 18 18 18 18 18 23 01 00 00 00 00 00 00 00 00 00 00 00 00 00 00 00 00 00 00
00 00 00 00 00 00 00 00 00 00 00 00 00 00 00 01 22 18 18 18 18 18 18 18 18 18 23 01 00 00 00 00 00 00 00 00 00 00 00 00 00 00 00 00 00 00
00 00 00 00 00 00 00 00 00 00 00 00 00 00 00 01 22 18 18 18 18 18 18 18 18 18 23 01 00 00 00 00 00 00 00 00 00 00 00 00 00 00 00 00 00 00
00 00 00 00 00 00 00 00 00 00 00 00 00 00 00 01 22 18 18 18 18 18 18 18 18 18 23 01 00 00 00 00 00 00 00 00 00 00 00 00 00 00 00 00 00 00
00 00 00 00 00 00 00 00 00 00 00 00 00 00 00 01 22 18 18 18 18 18 18 18 18 18 23 01 00 00 00 00 00 00 00 00 00 00 00 00 00 00 00 00 00 00
03 13 13 13 13 13 13 05 15 15 15 15 15 15 15 04 24 21 21 27 26 26 26 28 21 21 25 04 15 15 15 15 15 15 15 03 13 13 13 03 00 00 00 00 00 00
01 16 17 16 17 16 17 01 17 16 17 16 17 16 17 16 17 16 17 16 17 16 17 16 17 16 17 16 17 16 17 16 17 16 17 01 17 16 17 01 00 00 00 00 00 00
01 17 16 17 16 17 16 04 16 17 16 17 16 17 16 17 16 17 16 17 16 17 16 17 16 17 16 17 16 17 16 17 16 17 16 01 16 17 16 01 00 00 00 00 00 00
01 16 17 16 17 16 17 16 17 16 20 19 20 19 20 19 20 19 20 19 20 19 20 19 20 19 20 19 20 19 20 19 20 16 17 01 17 16 17 01 00 00 00 00 00 00
01 17 16 17 16 17 16 03 16 17 19 20 19 20 19 20 19 20 19 20 19 20 19 20 19 20 19 20 19 20 19 20 19 17 16 04 16 17 16 01 00 00 00 00 00 00
01 16 17 16 17 16 17 01 17 16 20 19 20 19 20 19 20 19 20 19 20 19 20 19 20 19 20 19 20 19 20 19 20 16 17 16 17 16 17 01 13 13 13 13 03 00
01 17 16 17 16 17 16 01 16 17 19 20 19 20 19 20 19 20 19 20 19 20 19 20 19 20 19 20 19 20 19 20 19 17 16 03 16 17 16 04 16 17 16 17 01 00
01 16 17 16 17 16 17 01 17 16 20 19 20 19 20 19 20 19 20 19 20 19 20 19 20 19 20 19 20 19 20 19 20 16 17 01 17 16 17 16 17 16 17 16 01 00
01 17 16 17 16 17 16 01 16 17 19 20 19 20 19 20 19 20 19 20 19 20 19 20 19 20 19 20 19 20 19 20 19 17 16 01 16 17 16 03 16 17 16 17 01 00
06 02 02 02 02 02 02 11 17 16 20 19 20 19 20 19 20 19 20 19 20 19 20 19 20 19 20 19 20 19 20 19 20 16 17 01 17 16 17 12 02 02 02 02 08 00
00 00 00 00 00 00 00 01 16 17 19 20 19 20 19 20 19 20 19 20 19 20 19 20 19 20 19 20 19 20 19 20 19 17 16 01 16 17 16 01 00 00 00 00 00 00
00 00 00 00 00 00 00 01 17 16 20 19 20 19 20 19 20 19 20 19 20 19 20 19 20 19 20 19 20 19 20 19 20 16 17 01 17 16 17 01 13 13 13 13 03 00
00 00 00 00 00 00 00 01 16 17 19 20 19 20 19 20 19 20 19 20 19 20 19 20 19 20 19 20 19 20 19 20 19 17 16 01 16 17 16 04 16 17 16 17 01 00
00 00 00 00 00 00 00 01 17 16 20 19 20 19 20 19 20 19 20 19 20 19 20 19 20 19 20 19 20 19 20 19 20 16 17 01 17 16 17 16 17 16 17 16 01 00
00 00 00 00 00 00 00 01 16 17 19 20 19 20 19 20 19 20 19 20 19 20 19 20 19 20 19 20 19 20 19 20 19 17 16 04 16 17 16 03 16 17 16 17 01 00
00 00 00 00 00 00 00 01 17 16 20 19 20 19 20 19 20 19 20 19 20 19 20 19 20 19 20 19 20 19 20 19 20 16 17 16 17 16 17 12 02 02 02 02 08 00
00 00 00 00 00 00 00 01 16 17 19 20 19 20 19 20 19 20 19 20 19 20 19 20 19 20 19 20 19 20 19 20 19 17 16 03 16 17 16 01 00 00 00 00 00 00
00 00 03 15 15 15 15 04 17 16 20 19 20 19 20 19 20 19 20 19 20 19 20 19 20 19 20 19 20 19 20 19 20 16 17 01 17 16 17 01 00 00 00 00 00 00
00 00 01 18 18 18 18 18 16 17 19 20 19 20 19 20 19 20 19 20 19 20 19 20 19 20 19 20 19 20 19 20 19 17 16 01 16 17 16 01 00 00 00 00 00 00
00 00 01 18 18 18 18 18 18 16 20 19 20 19 20 19 20 19 20 19 20 19 20 19 20 19 20 19 20 19 20 19 20 16 17 01 17 16 17 01 00 00 00 00 00 00
00 00 01 18 18 18 18 18 18 17 19 20 19 20 19 20 19 20 19 20 19 20 19 20 19 20 19 20 19 20 19 20 19 17 16 12 02 02 02 08 00 00 00 00 00 00
00 00 01 18 18 18 18 18 18 16 20 19 20 19 20 19 20 19 20 19 20 19 20 19 20 19 20 19 20 19 20 19 20 16 17 01 00 00 00 00 00 00 00 00 00 00
00 00 01 18 18 18 18 18 18 17 19 20 19 20 19 20 19 20 19 20 19 20 19 20 19 20 19 20 19 20 19 20 19 17 16 01 00 00 00 00 00 00 00 00 00 00
00 00 01 18 18 18 18 18 18 16 20 19 20 19 20 19 20 19 20 19 20 19 20 19 20 19 20 19 20 19 20 19 20 16 17 01 00 00 00 00 00 00 00 00 00 00
00 00 01 18 18 18 18 18 16 17 19 20 19 20 19 20 19 20 19 20 19 20 19 20 19 20 19 20 19 20 19 20 19 17 16 01 00 00 00 00 00 00 00 00 00 00
00 00 06 02 02 02 02 07 17 16 20 19 20 19 20 19 20 19 20 19 20 19 20 19 20 19 20 19 20 19 20 19 20 16 17 01 00 00 00 00 00 00 00 00 00 00
00 00 00 00 00 00 00 01 16 17 16 17 16 17 16 17 16 17 16 17 16 17 16 17 16 17 16 17 16 17 16 17 16 17 16 01 00 00 00 00 00 00 00 00 00 00
00 00 00 00 00 00 00 01 17 16 17 16 17 16 17 16 17 16 17 16 17 16 17 16 17 16 17 16 17 16 17 16 17 16 17 01 00 00 00 00 00 00 00 00 00 00
00 00 00 00 00 00 00 06 02 02 02 02 02 02 07 17 16 17 05 02 02 02 02 02 07 17 16 17 03 13 13 13 16 17 13 01 00 00 00 00 00 00 00 00 00 00
00 00 00 00 00 00 00 00 00 00 00 00 00 00 01 16 17 16 01 00 00 00 00 00 01 16 17 16 01 16 17 16 17 16 17 01 00 00 00 00 00 00 00 00 00 00
00 00 00 00 00 00 00 00 00 00 00 00 00 00 01 17 16 17 01 00 00 00 00 00 01 17 16 17 01 17 16 17 16 17 16 01 00 00 00 00 00 00 00 00 00 00
00 00 00 00 00 00 00 00 00 03 13 13 13 13 01 16 17 16 01 00 00 00 00 00 01 16 17 16 01 16 17 16 17 16 17 01 00 00 00 00 00 00 00 00 00 00
00 00 00 00 00 00 00 00 00 01 16 17 16 17 04 17 16 17 01 14 14 14 14 14 01 17 16 17 01 17 16 17 16 17 16 01 00 00 00 00 00 00 00 00 00 00
00 00 00 00 00 00 00 00 00 01 17 16 17 16 17 16 17 16 01 16 17 16 17 16 01 16 17 16 01 16 17 16 17 16 17 01 00 00 00 00 00 00 00 00 00 00
00 00 00 00 00 00 00 00 00 01 16 17 16 17 03 17 16 17 01 17 16 17 16 17 01 17 16 17 01 17 16 17 16 17 16 01 00 00 00 00 00 00 00 00 00 00
00 00 00 00 00 00 00 00 00 06 02 02 02 02 11 16 17 16 01 16 17 16 17 16 01 16 17 16 12 02 02 02 02 02 02 08 00 00 00 00 00 00 00 00 00 00
00 00 00 00 00 00 00 00 00 00 00 00 00 00 01 17 16 17 01 17 16 17 16 17 01 17 16 17 01 00 00 00 00 00 00 00 00 00 00 00 00 00 00 00 00 00
00 00 00 00 00 00 00 00 00 00 00 00 00 00 01 16 17 16 04 16 17 16 17 16 04 16 17 16 01 00 00 00 00 00 00 00 00 00 00 00 00 00 00 00 00 00
00 00 00 00 00 00 00 00 00 00 00 00 00 00 01 17 16 17 16 17 16 17 16 17 16 17 16 17 01 00 00 00 00 00 00 00 00 00 00 00 00 00 00 00 00 00
00 00 00 00 00 00 00 00 00 00 00 00 00 00 01 16 17 16 03 16 17 16 17 16 03 16 17 16 01 00 00 00 00 00 00 00 00 00 00 00 00 00 00 00 00 00
00 00 00 00 00 00 00 00 00 00 00 00 00 00 06 02 02 02 10 02 02 02 02 02 10 02 02 02 08 00 00 00 00 00 00 00 00 00 00 00 00 00 00 00 00 00
